11111111111111
1E0010C0000001
10000000000T01
1C000000000C01
11111111111111