11111111111
10001111111
1C111110011
110011E11P1
11111111111