111111111111111
100E010C00010C1
1000000110000T1
100000011010001
1P00110100110C1
111111111111111