11111111111111
1E000C000P1011
11111111111111