1111111111111
1000010C00001
1000100110111
1P00110100E01
1111111111111