111111111111111
1000011E10010C1
1000000010000T1
100000011000001
1P00110101C10C1
111111111111111
