11111111111111
100010C0000001
1P000000000T01
1C000000000C01
11111111111111