111111111

1000EC0P1
111111111