1111111111111
1E0100C0000C1
1000011111001
1P0011C000001
1111111111111
