1111111111111
10000000000P1
10000001100C1
1000110E00001
1111111111111
