111111111111111
111111111111111
11E0100C0000C11
110000111110T11
11P0011C0000011
111111111111111
111111111111111